14 15
|-------------|
|......|......|
|.-.--.|.--0-.|
|.............|
|.-.|.---.|.-.|
|...|..|..|...|
|--.|-.X.-|.--|
|--.---.---.--|
|-....XXX....-|
|--.-------.--|
|...---.---...|
|.-.--.@.--.-.|
|......|......|
|-------------|